1 110 123 139 255 1 0 0
1 110 123 139 255 1 1 0
1 110 123 139 255 1 2 0
1 110 123 139 255 1 3 0
1 110 123 139 255 1 4 0
1 110 123 139 255 1 5 0
1 110 123 139 255 1 0 1
1 110 123 139 255 1 5 1
1 110 123 139 255 1 0 2
1 110 123 139 255 1 1 2
1 110 123 139 255 1 2 2
1 110 123 139 255 1 3 2
1 110 123 139 255 1 4 2
1 110 123 139 255 1 5 2
0 255 255 255 255 0 1 1
0 255 255 255 255 0 2 1
0 255 255 255 255 0 3 1
0 255 255 255 255 0 4 1
3 255 0 255 255 1 1 1
2 0 255 0 255 0 4 1
4 0 255 0 255 1 2 1
